1111111111111111111111
1111111111111P00000CC1
1111111111000011111111
1111111111111000000E01
1111111111111101111111
1111111111111101111111
11111111111111C1111111
1111111111111111100111
1111111111111101110111
1111111111111101111111
1111111111111111111111
